12 12 12 12 12 12 12 12 12 12 12 12 12 12 12 12 12 12 12 12 12 12 12 12 12 12 12 12 12 12 12 12 12 12 12 12 12 12 12 12 12 12 12 12
12 12 12 12 12 12 12 12 12 12 12 12 12 12 12 12 12 12 12 12 12 12 12 12 12 12 12 12 12 12 12 12 12 12 12 12 12 12 12 12 12 12 12 12
12 12 12 12 12 12 12 12 12 12 12 12 12 12 12 12 12 12 12 12 12 12 12 12 12 12 12 12 12 12 12 12 12 12 12 12 12 12 12 12 12 12 12 12
12 12 12 12 12 12 12 12 12 12 12 12 12 12 12 12 12 12 12 12 12 12 12 12 12 12 12 12 12 12 12 12 12 12 12 12 12 12 12 12 12 12 12 12
12 12 12 12 12 12 12 12 12 12 18 18 12 12 12 12 12 12 12 12 12 12 12 12 12 12 12 12 12 12 12 12 12 12 12 12 12 12 12 12 12 12 12 12
12 12 12 12 12 12 12 12 12 12 18 18 12 12 12 12 12 12 12 12 12 12 12 12 12 12 12 12 12 12 12 12 12 12 12 12 12 12 12 12 12 12 12 12
12 12 12 12 12 12 12 15 10 10 14 14 10 10 10 10 10 12 12 12 12 12 12 12 12 12 12 12 12 10 10 10 10 12 12 12 12 12 12 12 12 12 12 12
12 12 12 12 12 12 12 15 10 10 13 13 10 10 10 10 10 10 10 10 10 10 12 12 12 12 12 12 10 10 10 10 10 12 12 12 12 12 12 12 12 12 12 12
12 12 12 12 12 12 12 15 10 10 13 13 13 10 10 10 10 10 10 10 10 10 10 10 10 10 10 10 10 10 10 10 10 10 10 10 19 12 12 12 12 12 12 12
12 12 12 12 12 12 12 15 16 10 13 13 13 10 10 10 10 10 10 10 10 10 10 10 10 10 10 10 10 10 10 10 10 10 10 16 19 12 12 12 12 12 12 12
12 12 12 12 12 12 12 12 22 10 13 13 13 13 13 10 10 10 10 10 10 10 10 10 10 10 10 10 10 10 10 10 10 10 10 23 12 12 12 12 12 12 12 12
12 12 12 12 12 12 12 12 20 10 13 13 13 13 13 13 13 13 13 13 13 13 13 13 13 13 13 13 10 10 10 10 10 10 10 23 12 12 12 12 12 12 12 12
12 12 12 12 12 12 12 12 15 10 13 13 13 13 13 13 13 13 13 13 13 13 13 13 13 13 13 13 10 10 10 10 10 10 10 10 19 12 12 12 12 12 12 12
12 12 12 12 12 12 12 12 15 10 10 10 10 10 10 10 10 10 10 10 10 10 10 10 10 10 10 13 10 10 10 10 10 10 16 16 19 12 12 12 12 12 12 12
12 12 12 12 12 12 12 15 10 10 10 10 10 10 10 10 10 10 10 10 10 10 10 10 10 10 10 13 13 13 13 10 10 10 23 17 12 12 12 12 12 12 12 12
12 12 12 12 12 12 12 15 10 10 10 10 10 10 10 10 10 10 10 10 10 10 10 10 10 10 10 10 10 13 13 10 10 10 21 11 12 12 12 12 12 12 12 12
12 12 12 12 12 12 12 15 10 10 10 10 10 10 10 10 10 10 10 10 10 10 10 10 10 10 10 10 10 13 13 10 10 10 19 12 12 12 12 12 12 12 12 12
12 12 12 12 12 12 12 15 10 10 10 10 10 10 10 10 10 10 10 10 10 10 10 10 10 10 10 10 10 13 13 10 10 10 10 19 12 12 12 12 12 12 12 12
12 12 12 12 12 12 12 15 10 10 10 10 10 10 10 10 10 10 10 10 10 10 10 10 10 10 10 10 10 13 13 10 10 10 10 19 12 12 12 12 12 12 12 12
12 12 12 12 12 12 12 15 10 10 10 10 10 10 10 10 10 10 10 10 10 10 10 10 10 10 10 10 10 13 13 10 10 10 10 19 12 12 12 12 12 12 12 12
12 12 12 12 12 12 12 15 10 10 10 10 10 10 10 10 10 10 10 10 10 10 10 10 10 10 10 10 10 13 13 10 10 10 10 19 12 12 12 12 12 12 12 12
12 12 12 12 12 12 12 12 22 10 10 10 10 10 10 10 10 10 10 10 10 10 10 10 10 10 10 10 10 13 13 10 10 10 10 10 19 12 12 12 12 12 12 12
12 12 12 12 12 12 12 12 20 16 10 10 10 10 10 10 10 10 10 10 10 10 10 10 10 10 10 10 10 13 13 10 10 10 10 16 19 12 12 12 12 12 12 12
12 12 12 12 12 12 12 12 12 22 10 10 10 10 10 10 10 10 10 10 10 10 10 10 10 10 10 10 10 10 10 10 10 10 10 23 12 12 12 12 12 12 12 12
12 12 12 12 12 12 12 12 12 20 10 10 10 10 10 10 10 10 10 10 10 10 10 10 10 10 10 10 10 10 10 10 10 10 10 21 12 12 12 12 12 12 12 12
12 12 12 12 12 12 12 12 12 15 10 10 10 10 10 10 10 10 10 10 16 16 16 16 16 16 10 10 10 10 10 10 10 10 10 19 12 12 12 12 12 12 12 12
12 12 12 12 12 12 12 12 15 10 10 10 10 10 10 10 10 10 10 10 23 17 17 17 17 22 10 10 10 10 10 10 10 10 10 19 12 12 12 12 12 12 12 12
12 12 12 12 12 12 12 12 15 10 10 10 10 10 10 10 10 10 10 10 21 11 11 11 11 20 10 10 10 10 10 10 10 10 10 19 12 12 12 12 12 12 12 12
12 12 12 12 12 12 12 15 10 10 10 10 10 10 10 10 10 10 10 10 19 12 12 12 12 15 10 10 10 10 10 10 10 10 10 10 19 12 12 12 12 12 12 12
12 12 12 12 12 12 12 15 16 16 16 16 16 16 16 16 16 16 16 16 16 16 19 12 12 15 16 16 16 16 16 16 16 16 16 16 19 12 12 12 12 12 12 12
12 12 12 12 12 12 12 12 17 17 17 17 17 17 17 17 17 17 17 17 17 17 12 12 12 12 17 17 17 17 17 17 17 17 17 17 12 12 12 12 12 12 12 12
12 12 12 12 12 12 12 12 11 11 11 11 11 11 11 11 11 11 11 11 11 11 12 12 12 12 11 11 11 11 11 11 11 11 11 11 12 12 12 12 12 12 12 12
12 12 12 12 12 12 12 12 12 12 12 12 12 12 12 12 12 12 12 12 12 12 12 12 12 12 12 12 12 12 12 12 12 12 12 12 12 12 12 12 12 12 12 12
12 12 12 12 12 12 12 12 12 12 12 12 12 12 12 12 12 12 12 12 12 12 12 12 12 12 12 12 12 12 12 12 12 12 12 12 12 12 12 12 12 12 12 12
12 12 12 12 12 12 12 12 12 12 12 12 12 12 12 12 12 12 12 12 12 12 12 12 12 12 12 12 12 12 12 12 12 12 12 12 12 12 12 12 12 12 12 12
12 12 12 12 12 12 12 12 12 12 12 12 12 12 12 12 12 12 12 12 12 12 12 12 12 12 12 12 12 12 12 12 12 12 12 12 12 12 12 12 12 12 12 12
12 12 12 12 12 12 12 12 12 12 12 12 12 12 12 12 12 12 12 12 12 12 12 12 12 12 12 12 12 12 12 12 12 12 12 12 12 12 12 12 12 12 12 12