616 616 616 616 616 616 616 616 616 616 616 616 616 617 751 433 434 435 750 615 616 616 616 616 616 616 616 616 616 616 616 616
287 287 287 287 287 287 287 287 287 287 287 287 287 287 745 433 434 435 749 287 287 287 287 287 287 287 287 287 287 287 287 287
287 751 755 756 755 756 755 756 755 756 755 756 755 756 744 433 434 435 748 755 756 755 756 755 756 755 756 755 756 755 750 574
287 751 796 797 796 797 796 797 796 797 796 797 796 797 743 433 434 435 747 796 797 796 797 796 797 796 797 796 797 796 750 574
287 751 837 838 837 838 837 838 837 838 837 838 837 838 742 433 434 435 746 837 838 837 838 837 838 837 838 837 838 837 750 574
287 751 738 739 738 739 738 739 738 739 738 739 738 739 740 465 466 467 741 738 739 738 739 738 739 738 739 738 739 738 750 574
287 751 370 370 370 370 370 370 370 370 370 370 370 370 370 370 370 370 370 370 370 370 370 370 370 370 370 293 370 370 750 574
287 751 370 370 370 370 370 370 293 370 370 370 370 370 370 370 370 370 370 370 370 370 370 370 370 370 370 370 370 370 750 574
287 751 370 370 370 370 370 370 370 370 370 370 370 370 370 370 370 370 370 370 370 370 370 370 370 370 370 370 370 370 750 574
287 751 370 370 370 370 370 370 370 370 370 370 370 370 370 370 370 370 370 370 375 370 370 370 370 370 370 370 370 370 750 574
287 751 370 370 370 370 370 370 370 370 370 370 370 370 370 370 370 370 370 370 370 370 370 370 370 375 370 370 370 370 750 574
287 751 370 370 370 370 370 375 370 370 370 370 370 370 370 370 370 370 370 370 370 370 370 370 370 370 370 370 370 370 750 574
287 751 370 370 370 370 370 370 370 370 370 370 370 370 370 370 370 370 370 370 370 370 370 370 370 370 370 370 370 370 750 574
287 751 370 370 370 370 370 370 370 370 370 370 370 370 370 370 370 370 370 370 370 370 370 370 370 370 370 370 370 370 750 574
287 754 752 752 752 752 370 370 370 370 370 370 370 370 370 370 370 370 370 370 370 370 370 370 370 370 370 370 370 370 750 574
287 287 287 287 287 751 370 370 866 867 867 867 867 867 867 867 867 867 867 867 867 867 867 867 867 867 867 868 370 370 750 574
287 287 287 287 287 751 370 370 907 908 908 908 908 908 908 908 908 908 908 908 908 908 908 908 908 908 908 909 370 370 750 574
287 287 287 287 287 751 370 370 907 908 908 908 908 908 908 908 908 908 908 908 908 908 908 908 908 908 908 909 370 370 750 574
287 287 287 287 287 751 370 370 907 908 908 908 908 908 908 908 908 908 908 908 908 908 908 908 908 908 908 909 370 370 750 574
287 287 287 287 287 751 370 370 907 908 908 908 908 908 908 908 908 908 908 908 908 908 908 908 908 908 908 909 370 370 750 574
287 287 287 287 287 751 370 370 907 908 908 908 908 908 908 908 908 908 908 908 908 908 908 908 908 908 908 909 370 370 750 574
287 751 755 756 755 756 370 370 907 908 908 908 908 908 908 908 908 908 908 908 908 908 908 908 908 908 908 909 370 370 750 574
287 751 796 797 796 797 370 370 907 908 908 908 908 908 908 908 908 908 908 908 908 908 908 908 908 908 908 909 370 370 750 574
287 751 837 838 837 838 370 370 907 908 908 908 908 908 908 908 908 908 908 908 908 908 908 908 908 908 908 909 370 370 750 574
287 751 738 739 738 739 370 370 948 949 949 949 949 949 949 949 949 949 949 949 949 949 949 949 949 949 949 950 370 370 750 574
287 751 370 370 370 370 370 370 370 370 370 370 370 370 370 370 370 370 370 370 370 370 370 370 370 370 370 370 370 370 750 574
287 751 370 370 370 370 370 370 370 370 370 370 370 370 370 370 370 370 370 370 370 370 370 370 370 370 370 370 294 370 750 574
287 751 370 370 370 370 370 370 370 370 370 370 370 370 370 370 370 370 370 370 370 370 370 370 370 370 370 370 370 370 750 574
287 751 370 370 370 294 370 370 370 370 370 370 294 370 370 370 370 370 370 370 370 370 370 370 370 370 370 370 370 370 750 574
287 751 370 370 370 370 370 370 375 370 370 370 370 370 370 370 370 370 370 370 375 370 370 370 370 370 370 370 370 370 750 574
287 751 370 370 370 370 370 370 370 370 370 370 370 370 370 370 370 370 370 370 370 370 370 370 370 370 370 370 370 370 750 574
287 751 370 370 370 370 370 370 370 370 370 370 370 370 370 370 370 370 370 370 370 370 370 370 370 370 370 370 370 370 750 574
