199 199 199 199 199 199 199 199 199 199 199 199 199 199 199 199 199 199 199 199 199 199 199 199 199 199 199 199 199 199 199 199 199 199 199 199 199 199 199 199 199 199 199 199 199 199 199 199 199 199
199 199 199 199 199 199 199 199 199 199 199 199 199 199 199 199 199 199 199 199 199 199 199 199 199 199 199 199 199 199 199 199 199 199 199 199 199 199 199 199 199 199 199 199 199 199 199 199 199 199
199 199 199 199 199 199 199 199 199 199 199 199 199 199 199 199 199 199 199 199 199 199 199 199 199 199 199 199 199 199 199 199 199 199 199 199 199 199 199 199 199 199 199 199 199 199 199 199 199 199
199 199 199 199 199 199 199 199 199 199 199 199 199 199 199 199 199 199 199 199 199 199 199 199 199 199 199 199 199 199 199 199 199 199 199 199 199 199 199 199 199 199 199 199 199 199 199 199 199 199
199 199 199 199 199 199 199 199 199 199 199 199 199 199 199 199 199 199 199 199 199 199 199 199 199 199 199 199 199 199 199 199 199 199 199 199 199 199 199 199 199 199 199 199 199 199 199 199 199 199
199 199 199 199 199 199 199 199 199 199 199 199 199 199 199 199 199 199 199 199 199 199 199 199 199 199 199 199 199 199 199 199 199 199 199 199 199 199 199 199 199 199 199 199 199 199 199 199 199 199
199 199 199 199 199 199 199 199 199 199 199 199 199 199 199 199 199 199 199 199 199 199 199 199 199 199 199 199 199 199 199 199 199 199 199 199 199 199 199 199 199 199 199 199 199 199 199 199 199 199
 16  16  16  16  16  16  16  16  16  16  16  16  16  16  16  16  16  16  16  16  16  16  16  16  16  16  16  16  16  16  16  16  16  16  16  16  16  16  16  16  16  16  16  16  16  16  16  16  16  16
287 287 287 287 287 287 287 287 287 287 287 287 287 287 287 287 287 287 287 287 287 287 287 287 287 287 287 287 287 287 287 287 287 287 287 287 287 287 287 287 287 287 287 287 287 287 287 287 287 287
287 287 287 287 287 287 287 287 287 287 287 287 287 287 287 287 287 287 287 287 287 287 287 287 287 287 287 287 287 287 287 287 287 287 287 287 287 287 287 287 287 287 287 287 287 287 287 287 287 287
287 287 287 287 287 287 287 287 287 287 287 287 287 287 287 287 287 287 287 287 287 287 287 287 287 287 287 287 287 287 287 287 287 287 287 287 287 287 287 287 287 287 287 287 287 287 287 287 287 287
287 287 287 287 287 287 287 287 287 287 287 287 287 287 287 287 287 287 287 287 287 287 287 287 287 287 287 287 287 287 287 287 287 287 287 287 287 287 287 287 287 287 287 287 287 287 287 287 287 287
287 287 287 287 287 287 287 287 287 287 287 287 287 287 287 287 287 287 287 287 287 287 287 287 287 287 287 287 287 287 287 287 287 287 287 287 287 287 287 287 287 287 287 287 287 287 287 287 287 287
287 287 287 287 287 287 287 287 287 287 287 287 287 287 287 287 287 287 287 287 287 287 287 287 287 287 287 287 287 287 287 287 287 287 287 287 287 287 287 287 287 287 287 287 287 287 287 287 287 287
287 287 287 287 287 287 287 287 287 287 287 287 287 287 287 287 287 287 287 287 287 287 287 287 287 287 287 287 287 287 287 287 287 287 287 287 287 287 287 287 287 287 287 287 287 287 287 287 287 287
287 287 287 287 287 287 287 287 287 287 287 287 287 287 287 287 287 287 287 287 287 287 287 287 287 287 287 287 287 287 287 287 287 287 287 287 287 287 287 287 287 287 287 287 287 287 287 287 287 287
287 287 287 287 287 287 287 287 287 287 287 287 287 287 287 287 287 287 287 287 287 287 287 287 287 287 287 287 287 287 287 287 287 287 287 287 287 287 287 287 287 287 287 287 287 287 287 287 287 287
287 287 287 287 287 287 287 287 287 287 287 287 287 287 287 287 593 504 505 506 506 506 506 506 506 506 506 506 506 506 506 506 506 672 287 287 287 287 287 287 287 287 287 287 287 287 287 287 287 287
287 287 287 287 287 287 287 287 287 287 287 287 287 287 287 287 593 504 505 547 546 547 546 546 546 547 546 547 546 546 546 547 506 672 287 287 287 287 287 287 287 287 287 287 287 287 287 287 287 287
287 287 287 287 287 287 287 287 287 287 287 287 287 287 287 287 593 504 505 547 546 546 546 547 547 547 546 546 546 547 546 547 547 732 287 287 287 287 287 287 287 287 287 287 287 287 287 287 287 287
287 287 287 287 287 287 287 287 287 287 287 287 287 287 287 287 727 331 433 434 434 434 434 434 434 434 434 434 434 434 434 434 435 731 718 719 718 719 718 719 718 719 718 719 733 287 287 287 287 287
287 287 287 287 722 718 719 718 719 718 719 718 719 718 719 718 726 372 433 434 434 434 434 434 434 434 434 434 434 434 434 434 435 730 714 715 714 715 714 715 714 715 714 715 734 733 287 287 287 287
287 287 722 721 720 714 715 714 715 714 715 714 715 714 715 714 725 372 433 434 434 434 434 434 434 434 434 434 434 434 434 434 435 729 710 711 710 711 710 711 710 711 710 711 735 734 733 287 287 287
718 719 720 717 716 710 711 710 711 710 711 710 711 710 711 710 724 372 433 434 434 434 434 434 434 466 466 466 466 466 466 466 467 728 706 707 706 707 706 707 706 707 706 707 736 735 734 733 287 287
714 715 716 713 712 706 707 706 707 706 707 706 707 706 707 706 706 372 433 434 434 434 434 434 435 287 287 287 287 287 287 287 369 370 370 370 370 370 370 370 370 370 370 370 370 736 735 734 718 719
710 711 712 709 708 370 370 370 370 370 370 370 370 370 370 370 370 372 433 434 434 434 434 434 435 287 287 287 287 287 287 287 369 370 370 370 370 370 370 370 370 370 370 370 370 370 736 735 714 715
706 707 708 370 370 370 370 370 370 370 370 370 370 370 370 370 370 372 433 434 434 434 434 434 435 287 287 287 287 287 287 287 369  13  14  14  14  14  14  14  14  15 370 370 370 370 370 736 710 711
370 370 370 370 370 370 370 370 370 370 370 370 370 370 370 370 370 372 433 434 434 434 434 434 435 287 287 287 287 287 287 287 369   8 199 199 199 199 199 199 199   9 370 370 370 370 370 370 706 707
370 370 370 370 370 370 370 370 370 370 370 370 370 370 370 370 370 372 433 434 434 434 434 434 435 287 287 287 287 287 287 287 369   8 199 199 199 199 199 199 199   9 370 370 370 370 370 370 370 370
411 411 411 411 411 411 411 411 411 411 411 411 411 411 411 373 401 402 434 434 434 434 434 434 434 402 403 287 287 287 287 287 369   8 199 199 199 199 199 199 199   9 370 370 370 370 370 370 370 370
287 287 328 329 329 329 329 329 329 329 329 331 287 287 287 287 433 434 434 434 434 434 434 434 434 434 435 328 329 331 287 287 369   8 199 199 199 199 199 199 199   9 370 370 370 370 370 370 370 370
287 287 369 370 370 370 370 370 370 370 370 372 287 287 287 287 433 434 434 434 434 434 434 434 434 434 435 369 370 372 287 287 369   8 199 199 199 199 199 199 199   9 370 370 370 370 370 370 370 370
287 287 369 370 370 370 370 370 370 370 370 372 247 247 247 247 433 434 434 434 434 434 434 434 434 434 435 369 370 372 287 287 369   8 199 199 199 199 199 199 199   9 370 370 370 370 370 370 370 370
287 287 369 370 370 370 370 370 370 370 370 372 247 247 247 247 433 434 434 434 434 434 434 434 434 434 435 369 370 372 287 287 369  10  11 199 199 199 199  11  11  12 370 370 370 370 370 370 370 370
287 287 369 370 370 370 370 370 370 370 370 372 247 247 247 247 433 434 434 434 434 434 434 434 434 434 435 410 411 411 287 287 369 370 370   8 199 199   9 370 370 370 370 370 370 370 370 370 370 370
287 287 369 370 370 370 370 370 370 370 370 372 287 287 287 287 465 466 466 466 434 434 434 466 466 466 467 287 287 287 287 287 369 370 370 199 199 199 199 370 370 370 373 374 374 374 374 374 374 374
287 287 369 370 370 370 370 370 370 370 370 372 287 287 287 287 287 287 287 287 433 434 435 287 287 287 287 287 287 287 287 287 691 695 699 695 699 695 699 695 699 703 287 287 287 287 287 287 287 287
287 287 369 370 370 370 370 370 370 370 370 372 287 287 287 287 287 287 287 287 433 434 435 287 287 287 287 287 287 287 287 287 690 694 698 694 698 694 698 694 698 701 287 287 287 287 287 287 287 287
287 287 369 370 370 370 370 370 370 370 370 372 287 287 287 287 287 287 287 287 433 434 435 287 287 287 287 287 287 287 287 287 689 693 697 693 697 693 697 693 697 701 287 287 287 287 287 287 287 287
287 287 410 412 370 373 374 374 374 374 374 373 287 287 287 401 403 287 287 287 433 434 435 287 287 287 287 287 287 287 287 287 688 674 673 704 705 704 705 704 673 700 287 287 287 287 287 287 287 287
291 291 291 333 370 401 402 402 402 402 402 402 402 402 402 434 434 402 402 402 434 434 435 287 287 287 287 287 287 287 287 287 687  39   3 199 199 199 199 199   6 737 287 287 287 287 287 287 287 287
374 374 374 374 412 433 434 434 434 434 434 434 434 434 434 434 434 434 434 434 434 434 435 287 287 287 287 287 287 287 287 287 687  39   3 199 199 199 199 199   6 737 287 287 287 287 287 287 287 287
287 287 287 287 369 465 466 466 466 466 466 466 466 466 466 466 466 466 466 466 466 466 467 287 287 287 287 287 287 287 287 287 687  39   3 199 199 199 199 199   6 737 287 287 287 287 287 287 287 287
287 287 287 287 369 372 287 287 287 287 287 287 287 287 287 287 287 287 287 287 287 287 287 287 287 287 287 287 287 287 287 287 687  39   3 199 199 199 199 199   6 737 287 287 287 287 287 287 287 287
287 287 287 287 369 372 287 287 287 287 287 287 287 287 287 287 287 287 287 287 287 287 287 287 287 287 287 287 287 287 287 287 687  39   3 199 199 199 199 199   6 737 287 287 287 287 287 287 287 287
287 287 287 287 369 372 287 287 287 287 287 287 287 287 287 287 287 287 287 287 287 287 287 287 287 287 287 287 287 287 287 287 687  39   3 199 199 199 199 199   6 737 287 287 287 287 287 287 287 287
287 287 287 287 369 372 287 287 287 287 287 287 287 287 287 287 287 287 287 287 287 287 287 287 287 287 287 287 287 287 287 686  39  39   3 199 199 199 199 199   6 737 287 287 287 287 287 287 287 287
287 287 287 287 369 372 287 287 287 287 287 287 287 287 287 287 533 534 534 534 534 534 535 287 287 287 287 287 287 685 686 684  39  39   3 199 199 199 199 199   6 737 287 287 287 287 287 287 287 287
287 287 287 287 369 372 287 287 287 287 287 287 287 287 287 287 574 575 497 575 575 497 576 287 287 287 287 685 686 684 683 682  39  39   3 199 199 199 199 199   6 737 287 287 287 287 287 287 287 287
675 676 675 676 505 506 675 676 675 676 675 676 679 680 287 287 615 616 616 616 616 616 617 287 287 685 686 684 683 682  39  39  39  39   3 199 199 199 199 199   6 737 287 287 287 287 287 287 287 287
673 674 673 674 505 506 673 674 673 674 673 674 681 681 679 680 287 287 287 287 287 287 287 685 686 684 683 682  39  39  72  72  99  39   3 199 199 199 199 199   6 737 287 287 287 287 287 287 287 287
 39  39  39  39  39  39  39  39  39  39  39  39 678 677 681 681 675 676 675 676 675 676 675 684 683 682  39  39  72  72  72  72  99  39   3 199 199 199 199 199   6 737 287 287 287 287 287 287 287 287
 64  66  65  65  65  65  65  65  65  65  65  65  65  65 678 673 674 673 674 673 674 673 674 682  39  39  39  72  72  72  72  72  99  39   3 199 199 199 199 199   6 737 287 287 287 287 287 287 287 287
 96  72  72  72  72  72  72  72  72  72  72  72  72  72  99  39  39  39  39  39  39  39  39  39  72  72  72  72  72  72  72  72  99   7   5 199 199 199 199 199   6 737 287 287 287 287 287 287 287 287
 96  72  72  72  72  72  72  72  72  72  72  72  72  72  72  65  65  65  65  98  72  72  72  72  72  72  72  72  72  72  72  72  99   3 199 199 199 199 199 199   6 737 287 287 287 287 287 287 287 287
 96  72  72  72  72  72  72  72  72  72  72  72  72  72  72  72  72  72  72  72  72  72  72  72  72  72  72  72  72  72  72  72  99   3 199 199 199 199 199 199   6 737 287 287 287 287 287 287 287 287
 96  72  72  72  72  72  72  72  72  72  72  72  72  72  72  72  72  72  72  72  72  72  72  72  72  72  72  72  72  72  72  72  99   3 199 199 199 199 199 199   6 737 287 287 287 287 287 287 287 287
 96  72  72  72  72  72  72  72  72  72  72  72  72  72  72  72  72  72  72  72  72  72  72  72  72  72  72  72  72  72  72  72  99   3 199 199 199 199 199 199   6 737 287 287 287 287 287 287 287 287
128  36  36  36  36  36  36  36  36  72  72  72  72  72  72  72  72  72  72  72  72  72  72  72  72  72  72  72  72  72  72  72  99   3 199 199 199 199 199 199   6 737 287 287 287 287 287 287 287 287
  1   1   1   1   1   1   1   1   2  96  72  72  72  72  72  72  72  72  72  72  72  72  72  72  72  72  72  72  72  72  72  72  99   3 199 199 199 199 199 199   6 737 287 287 287 287 287 287 287 287
199 199 199 199 199 199 199 199   6  96  72  72  72  72  72  72  72  72  72  72  72  72  72  72  72  72  72  72  72  72  72  72  99   3 199 199 199 199 199 199   6  96 679 680 287 287 287 287 287 287
199 199 199 199 199 199 199 199   6  96  72  72  72  72  72  72  72  72  72  72  72  72  72  72  72  72  72  72  72  72  72  72  99   3 199 199 199 199 199 199   6 128 677 681 675 676 675 676 675 676
199 199 199 199 199 199 199 199   6  96  72  72  72  72  72  72  72  72  72  72  72  72  72  72  72  72  72  72  72  72  72  72  99   3 199 199 199 199 199 199   4   2  39 678 673 674 673 674 673 674
199 199 199 199 199 199 199 199   6 128  36  36  36  36  36  36  36  36  36  36  36  36  36  36  36  36  36  36  36  36  36  36 131   3 199 199 199 199 199 199 199   4   2  39  39  39  39  39  39  39
199 199 199 199 199 199 199 199   4   1   1   1   1   1   1   1   1   1   1   1   1   1   1   1   1   1   1   1   1   1   1   1   1   5 199 199 199 199 199 199 199 199   4   1   1   1   1   1   1   1
199 199 199 199 199 199 199 199 199 199 199 199 199 199 199 199 199 199 199 199 199 199 199 199 199 199 199 199 199 199 199 199 199 199 199 199 199 199 199 199 199 199 199 199 199 199 199 199 199 199
199 199 199 199 199 199 199 199 199 199 199 199 199 199 199 199 199 199 199 199 199 199 199 199 199 199 199 199 199 199 199 199 199 199 199 199 199 199 199 199 199 199 199 199 199 199 199 199 199 199
199 199 199 199 199 199 199 199 199 199 199 199 199 199 199 199 199 199 199 199 199 199 199 199 199 199 199 199 199 199 199 199 199 199 199 199 199 199 199 199 199 199 199 199 199 199 199 199 199 199
199 199 199 199 199 199 199 199 199 199 199 199 199 199 199 199 199 199 199 199 199 199 199 199 135 135 135 135 135 135 135 135 135 135 135 199 199 199 199 199 199 199 199 199 199 199 199 199 199 199
135 135 135 135 135 135 135 135 135 135 135 135 135 135 135 135 135 135 135 135 135 135 135 135 135 135 135 135 135 135 135 135 135 135 135 135 135 135 135 135 135 135 135 135 135 199 199 199 199 199
135 135 135 135 135 135 135 135 135 135 135 135 135 135 135 135 135 135 135 135 135 135 135 135 135 135 135 135 135 135 135 135 135 135 135 135 135 135 135 135 135 135 135 135 135 135 135 135 135 135
135 135 135 135 135 135 135 135 135 135 135 135 135 135 135 135 135 135 135 135 135 135 135 135 135 135 135 135 135 135 135 135 135 135 135 135 135 135 135 135 135 135 135 135 135 135 135 135 135 135
135 135 135 135 135 135 135 135 135 135 135 135 135 135 135 135 135 135 135 135 135 135 135 135 135 135 135 135 135 135 135 135 135 135 135 135 135 135 135 135 135 135 135 135 135 135 135 135 135 135
135 135 135 135 135 135 135 135 135 135 135 135 135 135 135 135 135 135 135 135 135 135 135 135 135 135 135 135 135 135 135 135 135 135 135 135 135 135 135 135 135 135 135 135 135 135 135 135 135 135
135 135 135 135 135 135 135 135 135 135 135 135 135 135 135 135 135 135 135 135 135 135 135 135 135 135 135 135 135 135 135 135 135 135 135 135 135 135 135 135 135 135 135 135 135 135 135 135 135 135
